0 0 0 0 0 0 0 0 0 0 0 0 0 
1 1 1 1 1 1 1 1 1 1 1 1 0 
1 1 1 1 1 1 1 1 1 1 1 1 0 
1 1 1 1 1 1 1 1 1 1 1 1 0 
1 1 1 1 1 1 1 1 1 1 1 1 0 
1 1 1 1 1 1 1 1 1 1 1 1 0 
1 1 1 1 1 1 1 1 1 1 1 1 0 
1 1 1 1 1 1 1 1 1 1 1 1 1 
1 1 1 1 1 1 1 1 1 1 1 1 1 
0 0 0 0 1 1 1 1 1 1 1 1 1 
0 0 0 0 1 1 1 1 1 1 1 1 1 
0 0 0 0 1 1 1 1 1 1 1 1 0 
0 0 0 0 1 1 1 1 1 1 1 1 0 
0 0 0 0 1 1 1 1 1 1 1 1 0 
0 0 0 0 0 1 1 1 0 0 0 0 0 
0 0 0 0 0 1 1 1 0 0 0 0 0 
0 0 0 0 0 1 1 1 0 0 0 0 0 
-
0 0 0 0 0 0 0 0 0 0 0 0 0 
0 0 0 0 0 0 0 0 0 0 0 0 0 
0 0 0 0 0 0 0 0 0 0 0 0 0 
0 0 0 0 0 0 0 0 0 0 0 0 0 
0 0 0 0 0 0 0 0 0 0 0 0 0 
0 0 0 0 0 0 0 0 0 0 0 0 0 
0 0 0 0 0 0 0 0 0 0 0 0 0 
0 0 0 0 0 0 0 0 0 0 0 0 0 
0 0 0 0 0 0 0 0 0 0 0 0 0 
0 0 0 0 0 0 0 0 0 0 0 0 0 
0 0 0 0 0 0 0 0 0 0 0 0 0 
0 0 0 0 0 0 0 0 0 0 0 0 0 
0 0 0 0 0 0 0 0 0 0 0 0 0 
0 0 0 0 0 0 0 0 0 0 0 0 0 
0 0 0 0 0 0 0 0 0 0 0 0 0 
0 0 0 0 0 0 0 0 0 0 0 0 0 
0 0 0 0 0 0 0 0 0 0 0 0 0 
-
0 0 0 0 0 0 0 0 0 0 0 0 0 
27 27 27 27 27 27 27 27 27 27 27 4 6 
0 0 0 0 0 0 0 0 0 0 0 20 22 
0 0 0 0 0 0 0 0 0 0 0 20 22 
0 0 0 0 0 0 0 0 0 0 0 20 22 
0 0 0 0 0 0 0 0 0 0 0 20 22 
0 0 0 0 0 0 0 0 0 0 0 19 22 
0 0 0 0 0 0 0 0 0 0 0 29 27 
0 0 0 0 0 0 0 0 0 0 0 0 0 
27 27 4 6 0 0 0 0 0 0 0 0 0 
0 0 11 14 0 0 0 0 0 0 0 28 26 
0 0 11 22 0 0 0 0 0 0 0 31 22 
0 0 11 22 0 0 0 0 0 0 0 31 22 
0 0 11 18 24 0 0 28 26 26 26 5 7 
0 0 0 32 22 0 0 20 22 0 0 0 0 
0 0 0 32 22 0 0 20 13 0 0 0 0 
0 0 0 32 22 0 0 20 22 0 0 0 0 
